Id	Workflow Name/File	Tree?	searchSpace	# operators	# edges	# blocking edges	Top-down Exhaustive	Bottom-up Exhaustive	Bottom-up - Top-down	00111-searchFinished	00111-numStates	00111-OSEPCost	01111-searchFinished	Top-down Greedy	Bottom-up Greedy	Bottom-up Greedy - Top-down Greedy	01111-numStates	01111-OSEPCost	10111-searchFinished	10111-numStates	10111-OSEPCost	11111-searchFinished	11111-numStates	11111-OSEPCost
485	AU5800_CalPassFail_DataCompare	FALSE	80	105	112	32	65020	43455	-21565	TRUE	10251	3314	TRUE	96	20	-76	11	142724	TRUE	6151	3314	TRUE	2	3314
832	Convex Hull	FALSE	76	89	94	18	637	8704	8067	TRUE	86	223114	TRUE	46	59	13	6	227871	TRUE	1991	223114	TRUE	11	270609
2863	m_001_wahlstatistik_2021_import_daten	FALSE	68	103	116	48	28864	202351	173487	TRUE	5166	388511	TRUE	69	75	6	11	409671	FALSE	50002	388511	TRUE	17	1343253
2121	Microsoft Financial Statement Prior Year Tie Out	FALSE	62	70	77	15	82	971	889	TRUE	24	90500	TRUE	20	22	2	5	90500	TRUE	508	90500	TRUE	9	130744
2379	R4A_StructureHarmonisation_IDgenerator	FALSE	55	86	95	40	17	17	0	TRUE	11	10253	TRUE	8	4	-4	5	10253	TRUE	12	10253	TRUE	2	10253
822	Convert to (Decimal) Binary	FALSE	48	54	60	12	298	2059	1761	TRUE	145	8165	TRUE	17	16	-1	7	14680	TRUE	903	8165	TRUE	11	28926
590	casanissei	FALSE	48	75	87	39	26	43	17	TRUE	14	14059	TRUE	9	8	-1	5	14059	TRUE	28	14059	TRUE	4	22856
2063	Logistics _ Stock Forecast (nested-recursive equations)	FALSE	48	70	78	30	2043	4157	2114	TRUE	524	28926	TRUE	35	27	-8	11	28926	TRUE	1545	28926	TRUE	9	96055
2179	MTBF	FALSE	47	48	62	15	13	12	-1	TRUE	9	29674	TRUE	11	5	-6	4	29674	TRUE	14	29674	TRUE	4	53174
2075	LukesLocal	FALSE	46	85	88	42	4	3	-1	TRUE	4	14211	TRUE	4	2	-2	3	14211	TRUE	3	14211	TRUE	2	14211
912	CTC Scorecard	FALSE	46	68	73	27	1095	8924	7829	TRUE	284	3.22E+08	TRUE	33	27	-6	10	3.22E+08	TRUE	3849	3.22E+08	TRUE	12	3.22E+08
1253	fb01_int_games_scraper_Euro_2020	FALSE	41	60	62	21	11	7	-4	TRUE	6	329273	TRUE	4	4	0	3	329273	TRUE	8	329273	TRUE	3	329273
1674	Just KNIME It S02 _ CH09 _ Wine Quality	FALSE	41	54	64	23	7881	83978	76097	TRUE	1575	106460	TRUE	68	49	-19	12	106460	TRUE	31242	106460	TRUE	13	250909
49	02 Creating Your Sports Analytics Dataset	FALSE	40	57	57	17	3	2	-1	TRUE	3	24462	TRUE	4	2	-2	3	24462	TRUE	3	24462	TRUE	2	24462
2766	Trabajo de estructuracion de datos	FALSE	40	66	68	28	19	21	2	TRUE	16	37119	TRUE	6	4	-2	5	37119	TRUE	27	37119	TRUE	4	57918
2143	ML_proj	FALSE	40	53	60	20	273	1467	1194	TRUE	138	100133	TRUE	19	14	-5	9	100133	TRUE	900	100133	TRUE	10	222232
1883	KNIME_ListMonthsBetweenDates	FALSE	40	44	46	6	30	45	15	TRUE	21	10610	TRUE	8	5	-3	4	38488	TRUE	53	10610	TRUE	3	10610
892	CreditScoringModelDemo	FALSE	39	53	59	20	231	1518	1287	TRUE	142	109538	TRUE	23	15	-8	9	109538	TRUE	903	109538	TRUE	7	215007
867	Credit scoring 1	FALSE	39	52	58	19	276	1550	1274	TRUE	133	107737	TRUE	17	10	-7	9	107737	TRUE	898	107737	TRUE	4	107737
2207	neural_networks(1)	FALSE	39	53	59	20	280	1333	1053	TRUE	140	109233	TRUE	16	14	-2	9	109233	TRUE	900	109233	TRUE	9	403901
866	Building a Credit Scoring Model	FALSE	39	53	59	20	257	1772	1515	TRUE	139	109452	TRUE	16	16	0	9	109452	TRUE	902	109452	TRUE	7	304133
889	creditscore_project10	FALSE	39	53	59	20	423	2090	1667	TRUE	143	109446	TRUE	16	9	-7	9	109446	TRUE	902	109446	TRUE	4	109446
876	Credit scoring through Neural Network Standard Deviation	FALSE	39	53	59	20	133	619	486	TRUE	73	109553	TRUE	14	13	-1	8	109553	TRUE	455	109553	TRUE	8	265064
1895	KNIME_project10demo	FALSE	39	53	59	20	339	1388	1049	TRUE	141	109365	TRUE	19	19	0	9	109365	TRUE	903	109365	TRUE	10	320431
917	CustomerRiskPrediction	FALSE	39	52	58	19	289	1565	1276	TRUE	146	109575	TRUE	15	14	-1	9	109575	TRUE	901	109575	TRUE	9	470551
541	Building_A_Credit_Demo1	FALSE	38	52	58	20	323	1306	983	TRUE	150	109414	TRUE	21	18	-3	9	109414	TRUE	900	109414	TRUE	9	314991
1918	KNIME_projectcreditscoring	FALSE	38	52	58	20	265	1599	1334	TRUE	141	109678	TRUE	17	14	-3	9	109678	TRUE	901	109678	TRUE	5	204209
1	(test) credit score model	FALSE	38	52	58	20	245	1108	863	TRUE	139	109548	TRUE	14	12	-2	9	109548	TRUE	904	109548	TRUE	10	409609
1914	KNIME_projectans	FALSE	38	52	58	20	264	1326	1062	TRUE	143	109417	TRUE	28	11	-17	9	109417	TRUE	898	109417	TRUE	4	109417
1912	KNIME_project credit score	FALSE	38	52	58	20	337	1325	988	TRUE	137	109531	TRUE	17	17	0	9	109531	TRUE	902	109531	TRUE	8	175983
1904	KNIME_project8	FALSE	38	52	58	20	230	1184	954	TRUE	136	109327	TRUE	18	19	1	9	109327	TRUE	904	109327	TRUE	9	359370
2205	Neural _Network	FALSE	38	52	58	20	241	1140	899	TRUE	137	109449	TRUE	14	15	1	9	109449	TRUE	898	109449	TRUE	7	259525
1902	KNIME_project7 as	FALSE	38	52	58	20	160	578	418	TRUE	75	109532	TRUE	17	12	-5	8	109532	TRUE	455	109532	TRUE	5	114981
621	CC_Scoring	FALSE	38	52	58	20	255	1421	1166	TRUE	147	109485	TRUE	17	12	-5	9	109485	TRUE	902	109485	TRUE	8	175937
1900	KNIME_project3_Vipin	FALSE	38	52	58	20	106	499	393	TRUE	77	95204	TRUE	13	12	-1	8	95204	TRUE	453	95204	TRUE	7	200805
904	credit_scorng	FALSE	38	52	58	20	544	1265	721	TRUE	143	109355	TRUE	24	14	-10	9	109355	TRUE	900	109355	TRUE	11	414934
1882	KNIME_KhushiNarang	FALSE	38	52	58	20	329	1230	901	TRUE	142	109752	TRUE	23	11	-12	9	109752	TRUE	903	109752	TRUE	6	165291
1826	KNIME_Building a credit scoring model	FALSE	38	52	58	20	226	1151	925	TRUE	139	109555	TRUE	15	21	6	9	109555	TRUE	904	109555	TRUE	8	220623
902	CREDIT_SCORING Project	FALSE	38	52	58	20	134	536	402	TRUE	78	109522	TRUE	15	11	-4	8	109522	TRUE	453	109522	TRUE	8	220442
898	credit_scoretest	FALSE	38	52	58	20	247	1177	930	TRUE	141	109481	TRUE	19	9	-10	9	109481	TRUE	902	109481	TRUE	5	204012
900	credit_score_model	FALSE	38	52	58	20	298	1160	862	TRUE	136	109550	TRUE	18	13	-5	9	109550	TRUE	900	109550	TRUE	8	321094
2567	Sessional_Credit scoring project	FALSE	38	52	58	20	229	1007	778	TRUE	147	109663	TRUE	14	8	-6	9	109663	TRUE	904	109663	TRUE	6	209667
2210	New Project Credit Score	FALSE	38	52	58	20	256	1074	818	TRUE	141	109350	TRUE	15	8	-7	9	109350	TRUE	904	109350	TRUE	5	114820
2228	Nural_Network	FALSE	38	52	58	20	345	1109	764	TRUE	140	109178	TRUE	23	17	-6	9	109178	TRUE	902	109178	TRUE	8	220223
483	Asssesment Project Credit Scoring	FALSE	38	52	58	20	234	1173	939	TRUE	138	109178	TRUE	14	10	-4	9	109178	TRUE	904	109178	TRUE	6	253775
2346	Project.it	FALSE	38	52	58	20	180	446	266	TRUE	75	109589	TRUE	16	7	-9	8	109589	TRUE	455	109589	TRUE	6	209721
2206	Neuralnetwork_sumandDeviation	FALSE	38	52	58	20	250	1128	878	TRUE	148	109575	TRUE	14	13	-1	9	109575	TRUE	904	109575	TRUE	9	315158
2572	Shivam_kumar_jha_credit_scoring_knime_workflow	FALSE	38	52	58	20	202	914	712	TRUE	145	109325	TRUE	13	9	-4	9	109325	TRUE	903	109325	TRUE	7	303988
886	CreditScoreByAryan	FALSE	38	52	58	20	322	1243	921	TRUE	143	109382	TRUE	29	21	-8	9	109382	TRUE	902	109382	TRUE	8	264894
2184	Mudit Credit Score Project	FALSE	38	52	58	20	224	1439	1215	TRUE	137	109272	TRUE	19	10	-9	9	109272	TRUE	901	109272	TRUE	6	209270
2435	Regression_Asg3	FALSE	38	45	50	12	9	40	31	TRUE	7	160830	TRUE	3	4	1	2	160830	TRUE	64	160830	TRUE	7	160830
2084	MainProject	FALSE	38	52	58	20	226	1276	1050	TRUE	142	109390	TRUE	14	17	3	9	109390	TRUE	900	109390	TRUE	11	414966
1892	KNIME_project(sessional)	FALSE	38	52	58	20	296	1275	979	TRUE	140	109625	TRUE	15	17	2	9	109625	TRUE	901	109625	TRUE	7	215225
369	ACreditScoring	FALSE	38	52	58	20	231	1570	1339	TRUE	136	109506	TRUE	18	17	-1	9	109506	TRUE	904	109506	TRUE	9	315083
371	AdarshSingh_CreditScore Model	FALSE	38	52	58	20	133	561	428	TRUE	83	109359	TRUE	12	11	-1	8	109359	TRUE	455	109359	TRUE	8	289992
429	Amrit Anand	FALSE	38	52	58	20	250	1369	1119	TRUE	146	107092	TRUE	25	9	-16	9	107092	TRUE	903	107092	TRUE	4	107092
443	Ankit_Bhardwaj	FALSE	38	52	58	20	108	519	411	TRUE	71	109322	TRUE	14	6	-8	8	109322	TRUE	453	109322	TRUE	4	109322
459	AshishUpadhyay_Knime	FALSE	38	52	58	20	297	1550	1253	TRUE	139	109571	TRUE	21	14	-7	9	109571	TRUE	903	109571	TRUE	11	415150
467	assesment	FALSE	38	52	58	20	237	1189	952	TRUE	140	109052	TRUE	16	18	2	9	109052	TRUE	902	109052	TRUE	9	359099
469	Assessment1(Khushi Chaudhary-87)	FALSE	38	52	58	20	390	1170	780	TRUE	141	109359	TRUE	18	11	-7	9	109359	TRUE	902	109359	TRUE	6	209360
864	KNIME_project_creditScoring	FALSE	38	52	58	20	270	1337	1067	TRUE	146	109447	TRUE	17	11	-6	9	109447	TRUE	904	109447	TRUE	5	159513
894	Credit_Card_Scoring	FALSE	38	52	58	20	253	1676	1423	TRUE	144	109490	TRUE	20	18	-2	9	109490	TRUE	899	109490	TRUE	8	354087
896	credit_scoreassessment1	FALSE	38	52	58	20	359	1236	877	TRUE	149	109337	TRUE	17	17	0	9	109337	TRUE	902	109337	TRUE	11	414706
893	creditScoringWork	FALSE	38	52	58	20	319	1372	1053	TRUE	144	109806	TRUE	22	12	-10	9	109806	TRUE	902	109806	TRUE	7	259855
899	CREDIT_SCORE_	FALSE	38	52	58	20	405	1222	817	TRUE	144	109150	TRUE	15	14	-1	9	109150	TRUE	899	109150	TRUE	7	259207
888	creditscore_assesment	FALSE	38	52	58	20	472	1430	958	TRUE	151	109334	TRUE	21	10	-11	9	109334	TRUE	904	109334	TRUE	5	114782
887	credit score project 2	FALSE	38	52	58	20	315	1579	1264	TRUE	135	109721	TRUE	21	12	-9	9	109721	TRUE	902	109721	TRUE	7	304254
901	Credit_Score_project	FALSE	38	52	58	20	270	1398	1128	TRUE	139	109627	TRUE	18	8	-10	9	109627	TRUE	901	109627	TRUE	4	109627
891	CreditScoring1	FALSE	38	52	58	20	134	627	493	TRUE	68	109550	TRUE	16	14	-2	8	109550	TRUE	455	109550	TRUE	7	259598
903	Credit_Scoring_Assessment1	FALSE	38	52	58	20	312	1184	872	TRUE	140	109375	TRUE	17	31	14	9	109375	TRUE	903	109375	TRUE	8	264888
470	assessment1	FALSE	38	52	58	20	261	1313	1052	TRUE	146	109324	TRUE	20	14	-6	9	109324	TRUE	901	109324	TRUE	8	309454
468	assesment1	FALSE	38	52	58	20	334	1368	1034	TRUE	146	109052	TRUE	17	37	20	9	109052	TRUE	903	109052	TRUE	6	209055
458	AryanDevbrat_Credit_Scoring	FALSE	38	52	58	20	343	1459	1116	TRUE	141	109391	TRUE	17	14	-3	9	109391	TRUE	904	109391	TRUE	7	212048
905	cred_scoring_model	FALSE	38	52	58	20	338	1692	1354	TRUE	138	109302	TRUE	16	11	-5	9	109302	TRUE	899	109302	TRUE	5	203833
897	Credit_Score via Nural network	FALSE	38	52	58	20	319	1251	932	TRUE	145	107679	TRUE	20	19	-1	9	107679	TRUE	903	107679	TRUE	11	410290
384	Aditya_credit score model	FALSE	38	52	58	20	255	1253	998	TRUE	143	109087	TRUE	15	14	-1	9	109087	TRUE	901	109087	TRUE	10	320153
1045	Deepak credit scoring	FALSE	38	52	58	20	384	1401	1017	TRUE	141	109595	TRUE	24	17	-7	9	109595	TRUE	900	109595	TRUE	7	259654
1109	dubeyproject	FALSE	38	52	58	20	258	1247	989	TRUE	145	109600	TRUE	20	15	-5	9	109600	TRUE	902	109600	TRUE	10	365113
1161	examcredit	FALSE	38	52	58	20	304	1600	1296	TRUE	137	109522	TRUE	21	18	-3	9	109522	TRUE	902	109522	TRUE	11	415122
1927	KNIME_project_credit_scoring	FALSE	38	52	58	20	392	1232	840	TRUE	148	109446	TRUE	20	17	-3	9	109446	TRUE	902	109446	TRUE	8	398644
1825	KNIME_Assessment1{JEEWAN KARKI - 2001330130079}	FALSE	38	52	58	20	326	1627	1301	TRUE	147	109185	TRUE	14	18	4	9	109185	TRUE	903	109185	TRUE	11	414762
1911	KNIME_project credit	FALSE	38	52	58	20	274	1769	1495	TRUE	144	109369	TRUE	21	19	-2	9	109369	TRUE	903	109369	TRUE	6	164904
1857	KNIME_CreditScore_Krishna_Gupta	FALSE	38	52	58	20	296	1493	1197	TRUE	139	109571	TRUE	20	15	-5	9	109571	TRUE	903	109571	TRUE	7	215020
1859	KNIME_CreditScoring_Mukund	FALSE	38	52	58	20	145	528	383	TRUE	82	95168	TRUE	12	13	1	8	95168	TRUE	452	95168	TRUE	8	161624
1055	DemoCreditScore	FALSE	38	52	58	20	308	1783	1475	TRUE	147	109610	TRUE	24	24	0	9	109610	TRUE	904	109610	TRUE	6	254207
1824	KNIME_AssesmentCreditScore	FALSE	38	52	58	20	369	1260	891	TRUE	152	109168	TRUE	14	18	4	9	109168	TRUE	900	109168	TRUE	11	414748
885	credit score assesment question	FALSE	38	52	58	20	271	1307	1036	TRUE	135	109605	TRUE	15	12	-3	9	109605	TRUE	903	109605	TRUE	5	204142
872	Credit Scoring Model Project	FALSE	38	52	58	20	291	1522	1231	TRUE	134	109270	TRUE	21	14	-7	9	109270	TRUE	903	109270	TRUE	7	303927
868	Credit Scoring Assesment 1 Project	FALSE	38	52	58	20	262	1929	1667	TRUE	147	109387	TRUE	16	11	-5	9	109387	TRUE	898	109387	TRUE	4	109387
855	created scoring	FALSE	38	52	58	20	275	1140	865	TRUE	141	109692	TRUE	14	15	1	9	109692	TRUE	904	109692	TRUE	9	270673
874	Credit scoring through Neural Network, Sum and Standard Deviation on KNIME	FALSE	38	52	58	20	6	13	7	TRUE	7	123672	TRUE	3	5	2	4	123672	TRUE	30	123672	TRUE	6	311242
865	credit Score	FALSE	38	52	58	20	481	1228	747	TRUE	145	109605	TRUE	17	13	-4	9	109605	TRUE	903	109605	TRUE	9	315184
1177	exam_creditscoring	FALSE	38	52	58	20	314	1501	1187	TRUE	142	109285	TRUE	17	16	-1	9	109285	TRUE	904	109285	TRUE	6	120204
878	Credit Scoring Via Neutral Network	FALSE	38	52	58	20	334	1443	1109	TRUE	136	108910	TRUE	16	19	3	9	108910	TRUE	901	108910	TRUE	9	314359
869	Credit scoring by neural network	FALSE	38	52	58	20	294	1255	961	TRUE	133	109602	TRUE	20	15	-5	9	109602	TRUE	901	109602	TRUE	5	204133
871	Credit Scoring Model	FALSE	38	52	58	20	473	1252	779	TRUE	148	109468	TRUE	16	11	-5	9	109468	TRUE	904	109468	TRUE	6	164999
873	credit scoring project	FALSE	38	52	58	20	328	1835	1507	TRUE	143	109343	TRUE	19	14	-5	9	109343	TRUE	901	109343	TRUE	8	220424
870	CREDIT SCORING KNIME PROJECT	FALSE	38	52	58	20	279	1293	1014	TRUE	134	109278	TRUE	19	12	-7	9	109278	TRUE	904	109278	TRUE	6	164817
877	Credit Scoring Via Neural Network	FALSE	38	52	58	20	261	1319	1058	TRUE	148	109358	TRUE	24	13	-11	9	109358	TRUE	904	109358	TRUE	5	114829
879	credit Scoring_proj	FALSE	38	52	58	20	317	1220	903	TRUE	139	109124	TRUE	20	13	-7	9	109124	TRUE	904	109124	TRUE	6	164643
880	CreditBuildingModelDEmo	FALSE	38	52	58	20	260	1659	1399	TRUE	137	108988	TRUE	17	20	3	9	108988	TRUE	904	108988	TRUE	11	414575
1796	knime project credit scoring	FALSE	38	52	58	20	328	1364	1036	TRUE	142	109491	TRUE	22	20	-2	9	109491	TRUE	903	109491	TRUE	10	409310
884	creditscore127	FALSE	38	52	58	20	367	1267	900	TRUE	142	109542	TRUE	24	15	-9	9	109542	TRUE	900	109542	TRUE	10	320590
881	creditcardscoring	FALSE	38	52	58	20	259	1764	1505	TRUE	139	109462	TRUE	19	23	4	9	109462	TRUE	903	109462	TRUE	11	415033
895	credit_project4	FALSE	38	52	58	20	156	594	438	TRUE	74	109852	TRUE	20	17	-3	8	109852	TRUE	452	109852	TRUE	8	220906
1867	KNIME_FA analysis_TN	FALSE	37	40	42	5	132	111	-21	TRUE	131	2176	TRUE	10	2	-8	9	2176	TRUE	136	2176	TRUE	2	2176
1905	KNIME_project9- building a credit scoring model	FALSE	37	51	57	20	284	1474	1190	TRUE	142	109683	TRUE	22	10	-12	9	109683	TRUE	898	109683	TRUE	5	204214
1858	KNIME_CreditScoringAssesment	FALSE	37	51	57	20	200	1410	1210	TRUE	133	109309	TRUE	14	17	3	9	109309	TRUE	902	109309	TRUE	11	414885
540	Building_a_creditscoring_model	FALSE	37	51	57	20	252	1237	985	TRUE	145	109366	TRUE	17	18	1	9	109366	TRUE	902	109366	TRUE	10	409526
547	bulding a credit card	FALSE	37	51	57	20	339	1326	987	TRUE	141	109367	TRUE	20	18	-2	9	109367	TRUE	904	109367	TRUE	9	270362
2724	Testknime	FALSE	37	53	59	22	214	1004	790	TRUE	142	107870	TRUE	16	13	-3	9	107870	TRUE	903	107870	TRUE	6	118786
1256	FEP analysis 1-2	FALSE	36	41	45	9	856	1716	860	TRUE	650	21292	TRUE	12	12	0	10	72580	TRUE	1420	21292	TRUE	9	232572
2211	News as Text	FALSE	36	49	53	17	3	2	-1	TRUE	2	28380	TRUE	2	2	0	2	28380	TRUE	2	28380	TRUE	2	28380
2561	Sequence descriptors	FALSE	35	42	43	8	7	5	-2	TRUE	8	12534	TRUE	4	3	-1	4	12534	TRUE	14	12534	TRUE	3	12534
532	Bocquet_Mickaël_1_workflow_KNIME_102023	FALSE	34	48	47	13	1	1	0	TRUE	2	2266	TRUE	1	1	0	2	2266	TRUE	2	2266	TRUE	2	2266
1262	Ficha 8	FALSE	34	36	44	10	1664	9650	7986	TRUE	1041	70303	TRUE	29	16	-13	12	70303	TRUE	7179	70303	TRUE	10	236969
2282	Performance v5	FALSE	32	59	58	26	4	2	-2	TRUE	3	122639	TRUE	2	2	0	3	122639	TRUE	4	122639	TRUE	2	122639
2586	Austin2024	FALSE	31	39	42	11	12	24	12	TRUE	12	57806	TRUE	5	3	-2	4	57806	TRUE	63	57806	TRUE	5	57806
2144	ROC_model_comparison	FALSE	30	40	46	16	42	34	-8	TRUE	47	12471	TRUE	7	2	-5	6	12471	TRUE	33	12471	TRUE	2	72610
30	01_CreditScoring	FALSE	30	47	53	23	14	49	35	TRUE	12	109543	TRUE	5	5	0	5	109543	TRUE	58	109543	TRUE	5	159609
1102	DrugDiscovery - compound properties predictions	FALSE	30	53	63	33	204	1703	1499	TRUE	78	4373996	TRUE	17	23	6	6	4904060	TRUE	966	4373996	TRUE	11	6038241
1072	Diabetes2	FALSE	29	42	44	15	2	1	-1	TRUE	2	6767	TRUE	2	1	-1	2	6767	TRUE	2	6767	TRUE	2	6767
1926	KNIME_project_ass3	FALSE	28	39	42	14	1130	1416	286	TRUE	1031	1464695	TRUE	12	3	-9	12	1464695	TRUE	1034	1464695	TRUE	2	1464695
1926	KNIME_project_ass3	FALSE	28	39	42	14	1130	1416	286	TRUE	1031	1464695	TRUE	12	3	-9	12	1464695	TRUE	1034	1464695	TRUE	2	1464695
1152	ES1	FALSE	28	39	42	14	53	33	-20	TRUE	85	4021	TRUE	5	2	-3	8	4021	TRUE	53	4021	TRUE	2	4021
2111	MCSS 1-3	FALSE	28	28	31	3	1170	2053	883	TRUE	1218	88786	TRUE	8	7	-1	10	105142	TRUE	2950	88786	TRUE	8	599298
2283	m_001_poisson	FALSE	27	27	30	3	8	5	-3	TRUE	19	11143	TRUE	4	1	-3	6	11143	TRUE	17	11143	TRUE	2	11143
2131	Missing Loop Refinement	FALSE	27	27	30	3	8	10	2	TRUE	10	665692	TRUE	3	2	-1	3	704566	TRUE	26	665692	TRUE	6	709693
1073	Training	FALSE	27	38	39	12	2	1	-1	TRUE	2	102561	TRUE	2	1	-1	2	102561	TRUE	2	102561	TRUE	2	102561
679	Challenge 33 Medical Procedure Prices	FALSE	25	38	40	15	5	4	-1	TRUE	4	32434	TRUE	5	2	-3	3	32434	TRUE	8	32434	TRUE	4	44162
1888	KNIME_PRDT01	FALSE	25	51	50	25	2	1	-1	TRUE	2	190852	TRUE	2	2	0	2	190852	TRUE	2	190852	TRUE	2	190852
2622	split rows by lowest quant in row number	FALSE	25	42	48	23	5	6	1	TRUE	6	24661	TRUE	3	3	0	4	24661	TRUE	15	24661	TRUE	4	37704
1173	ClassificationClusterLDA	FALSE	25	36	37	12	2	1	-1	TRUE	2	55725	TRUE	2	1	-1	2	55725	TRUE	2	55725	TRUE	2	55725
1292	Financial _ Estimating Monthly Invoicing from Usage Periods	FALSE	24	40	45	21	195	504	309	TRUE	114	21518	TRUE	9	10	1	6	41562	TRUE	429	21518	TRUE	6	41562
1536	JKISeason2-24	FALSE	24	32	35	11	4	4	0	TRUE	4	53674	TRUE	3	2	-1	2	53674	TRUE	8	53674	TRUE	4	53674
2575	Similarity 1-2	FALSE	23	28	28	5	3	4	1	TRUE	8	947449	TRUE	2	2	0	4	947449	TRUE	14	947449	TRUE	3	947449
1745	justknimeit - 17 - Raffaello Barri	FALSE	23	38	39	16	2	1	-1	TRUE	2	52126	TRUE	2	1	-1	2	52126	TRUE	2	52126	TRUE	2	52126
448	s_420_spark_h2o_apply	FALSE	23	44	48	25	2	1	-1	TRUE	3	102485	TRUE	3	2	-1	3	102485	TRUE	4	102485	TRUE	2	102485
607	Case9B-Calibrating Clustering Indicators WTVR and Compactness	FALSE	23	28	29	6	1	1	0	TRUE	2	8974716	TRUE	2	0	-2	2	8974716	TRUE	2	8974716	TRUE	2	8974716
2543	SCD Type 7 (Beta)	FALSE	23	34	40	17	80	143	63	TRUE	73	17176	TRUE	10	3	-7	8	17176	TRUE	197	17176	TRUE	3	17176
1765	KPCA	FALSE	22	27	34	12	262	29387	29125	TRUE	154	93456	TRUE	12	14	2	9	93456	TRUE	32648	93456	TRUE	14	195515
2563	Session - IRIS Classification & Prediction - Basic	FALSE	22	49	54	32	3	1	-2	TRUE	4	6546	TRUE	1	1	0	3	6546	TRUE	3	6546	TRUE	2	6546
2348	PROJECT_START	FALSE	22	29	34	12	40	66	26	TRUE	59	21708	TRUE	6	4	-2	7	21708	TRUE	89	21708	TRUE	4	32378
709	kn_forum_42385_replace_strings_questionnaire	FALSE	22	28	29	7	3	2	-1	TRUE	6	2737	TRUE	1	2	1	4	2737	TRUE	6	2737	TRUE	2	2737
721	kn_forum_48440_join_long_texts	FALSE	22	32	36	14	33	343	310	TRUE	40	48438	TRUE	6	8	2	7	48438	TRUE	486	48438	TRUE	10	104755
1631	Just KNIME it-2_Challenge-24_v1	FALSE	22	24	27	5	550	413	-137	TRUE	517	13970	TRUE	7	3	-4	9	38696	TRUE	517	13970	TRUE	2	13970
1665	Just KNIME it 33	FALSE	22	46	47	25	4	4	0	TRUE	3	88208	TRUE	3	1	-2	2	88208	TRUE	4	88208	TRUE	3	88208
1533	JKISeason2-19_LF	FALSE	22	52	55	33	3	2	-1	TRUE	3	2811	TRUE	5	2	-3	3	2811	TRUE	4	2811	TRUE	2	2811
592	Case1-Mapping and Analyzing Population Density Pattern in Baton Rouge	FALSE	21	27	27	6	2	1	-1	TRUE	2	39891	TRUE	2	1	-1	2	39891	TRUE	2	39891	TRUE	2	39891
484	A template pattern for Cumulative Calculations using Standard Nodes with a Recursive Loop	FALSE	21	19	24	3	2118	1271	-847	TRUE	2653	10527	TRUE	6	4	-2	8	41228	TRUE	1549	10527	TRUE	3	10527
2238	OneHotCodingProcessForMultivalueVariableSample	FALSE	21	23	27	6	94	223	129	TRUE	141	23908	TRUE	7	6	-1	7	71428	TRUE	392	23908	TRUE	8	229550
1234	Extract groups from Excel file in a loop	FALSE	21	25	26	5	1	1	0	TRUE	2	5146	TRUE	1	1	0	2	5146	TRUE	2	5146	TRUE	2	5146
2729	Text cell parsing	FALSE	21	23	23	2	1	1	0	TRUE	2	3602	TRUE	2	1	-1	2	3602	TRUE	2	3602	TRUE	2	3602
1687	Just KNIME It _ Challenge 012	FALSE	21	35	36	15	4	9	5	TRUE	5	27752	TRUE	3	4	1	2	27752	TRUE	16	27752	TRUE	5	27752
365	ACADEMIC_PERFORMANCE_2021	FALSE	21	27	30	9	3	3	0	TRUE	4	399095	TRUE	2	2	0	2	399095	TRUE	8	399095	TRUE	4	399095
1077	differential_analysis_of_protein data	FALSE	21	30	30	9	2	1	-1	TRUE	2	2056	TRUE	2	1	-1	2	2056	TRUE	2	2056	TRUE	2	2056
1503	jKi-18	FALSE	20	26	28	8	86	127	41	TRUE	117	90795	TRUE	5	4	-1	7	98959	TRUE	165	90795	TRUE	4	116895
1744	justknimeit - 15 - Raffaello Barri	FALSE	20	21	23	3	1	1	0	TRUE	2	120148	TRUE	1	1	0	2	120148	TRUE	2	120148	TRUE	2	120148
1776	KNIME-Maestro connector	FALSE	20	21	21	1	2	2	0	TRUE	4	608738	TRUE	1	2	1	3	608738	TRUE	8	608738	TRUE	3	608738
2099	Match columns with library (string distance) - D_Valle v1	FALSE	20	27	30	10	8	15	7	TRUE	10	129350	TRUE	4	4	0	4	129350	TRUE	31	129350	TRUE	5	395906
2309	prassitismo lucca luglio 2021	FALSE	20	36	35	15	2	1	-1	TRUE	2	13435	TRUE	2	1	-1	2	13435	TRUE	2	13435	TRUE	2	13435
604	Case 7-PCA FA CA and application in Social Area Analysis	FALSE	20	37	39	19	3	4	1	TRUE	4	118602	TRUE	3	1	-2	3	118602	TRUE	8	118602	TRUE	3	118602
2185	Multi Layer Perceptron (MLP) on Oscillator Physics Problem	FALSE	19	22	27	8	11	20	9	TRUE	18	10545	TRUE	4	3	-1	5	10545	TRUE	59	10545	TRUE	6	18722
308	311022-311036	FALSE	19	40	52	33	28	32	4	TRUE	33	30896	TRUE	7	2	-5	7	30896	TRUE	37	30896	TRUE	2	30896
920	CVD1 Automation	FALSE	19	34	37	18	146	457	311	TRUE	139	243590	TRUE	9	11	2	7	427968	TRUE	391	243590	TRUE	8	837651
1154	ESIFARM2019-TEST	FALSE	19	22	26	7	5	11	6	TRUE	6	3.09E+07	TRUE	2	3	1	2	3.09E+07	TRUE	32	3.09E+07	TRUE	6	3.09E+07
1290	Financial_NEWS_Sentiment_Analysis	FALSE	19	36	41	22	3	2	-1	TRUE	3	2.87E+07	TRUE	3	2	-1	2	2.87E+07	TRUE	4	2.87E+07	TRUE	3	2.87E+07
1282	Final Project - Keplar Planets	FALSE	19	34	36	17	2	3	1	TRUE	4	1985585	TRUE	2	2	0	2	1985585	TRUE	8	1985585	TRUE	4	1985585
1717	justknimeit-34 - Word Scramble	FALSE	19	37	34	15	2	1	-1	TRUE	2	5911	TRUE	2	1	-1	2	5911	TRUE	2	5911	TRUE	2	5911
789	Compare confo search methods	FALSE	19	20	22	3	3	3	0	TRUE	10	3773	TRUE	1	2	1	4	3773	TRUE	15	3773	TRUE	5	9428
309	311022_311036	FALSE	19	40	52	33	27	26	-1	TRUE	33	30896	TRUE	7	3	-4	7	30896	TRUE	36	30896	TRUE	2	30896
759	CMiP Sentiment Analysis	FALSE	18	32	32	14	13	7	-6	TRUE	21	33474	TRUE	4	2	-2	6	33474	TRUE	20	33474	TRUE	2	33474
2239	OneHotCodingProcessForSingleValueVariableSample	FALSE	18	18	22	4	116	221	105	TRUE	142	28235	TRUE	10	5	-5	9	28235	TRUE	391	28235	TRUE	8	201658
2326	Preppin' Data - Week 2 - Average Price Analysis	FALSE	18	18	20	2	1	1	0	TRUE	2	21178	TRUE	1	1	0	2	21178	TRUE	2	21178	TRUE	2	21178
1058	xml replacer and insert with xml demo files using xslt	FALSE	18	23	24	6	2	5	3	TRUE	7	3397	TRUE	2	1	-1	4	3397	TRUE	6	3397	TRUE	2	3397
1328	kn_forum_42327_first_position_not_null	FALSE	18	22	24	6	4	5	1	TRUE	8	46065	TRUE	4	1	-3	3	46065	TRUE	15	46065	TRUE	4	46065
610	Case11B2-Location-Allocation Analysis of Hospitals-Part 2 location-allocation	FALSE	18	18	20	2	15	12	-3	TRUE	37	6147027	TRUE	3	1	-2	5	6160565	TRUE	35	6147027	TRUE	2	6147027
2684	table_transformation_solution	FALSE	17	20	21	4	2	2	0	TRUE	4	10614	TRUE	2	1	-1	3	10614	TRUE	7	10614	TRUE	3	10614
198	20200331_Pikairos_Substract_Between_Two_Different_Tables	FALSE	17	27	30	13	9	11	2	TRUE	13	18592	TRUE	3	3	0	5	18592	TRUE	26	18592	TRUE	5	45196
2909	02_XML_processing_(Bush_books)_XPath_mo_working	FALSE	17	24	24	7	2	1	-1	TRUE	2	5689	TRUE	2	1	-1	2	5689	TRUE	2	5689	TRUE	2	5689
1576	JKI_008_Wordle_Scores_on_Average	FALSE	17	47	51	34	27	25	-2	TRUE	33	42704	TRUE	6	3	-3	7	42704	TRUE	33	42704	TRUE	2	42704
1791	kn_forum_44856_calculate_weeks	FALSE	17	23	27	10	9	8	-1	TRUE	19	10569	TRUE	3	2	-1	6	10569	TRUE	18	10569	TRUE	2	10569
2621	kn_forum_44426_rank_with_rule	FALSE	17	20	20	3	1	1	0	TRUE	2	34953	TRUE	1	0	-1	2	34953	TRUE	2	34953	TRUE	2	34953
1057	dtc_001_column_reference	FALSE	16	24	26	10	5	7	2	TRUE	10	8982	TRUE	3	2	-1	4	8982	TRUE	15	8982	TRUE	3	8982
651	Challenge 17 Housing Market Madness	FALSE	16	28	28	12	1	0	-1	TRUE	2	24271	TRUE	1	1	0	2	24271	TRUE	2	24271	TRUE	2	24271
2734	text_clustering	FALSE	16	19	20	4	1	1	0	TRUE	3	6237666	TRUE	1	1	0	2	6237666	TRUE	4	6237666	TRUE	3	6237666
1761	K-Means Under the Hood	FALSE	16	22	27	11	8	13	5	TRUE	11	16891	TRUE	5	3	-2	5	16891	TRUE	28	16891	TRUE	3	16891
1235	kn_forum_39997_parsing_hierarchical_data	FALSE	16	24	25	9	2	1	-1	TRUE	3	6907	TRUE	3	1	-2	3	6907	TRUE	3	6907	TRUE	2	6907
2248	Oscar	FALSE	16	24	25	9	7	6	-1	TRUE	17	5036	TRUE	3	2	-1	6	5036	TRUE	21	5036	TRUE	2	5036
2089	Making the Pass, Part 2 - Model Analysis	FALSE	16	24	27	11	5	4	-1	TRUE	10	96071	TRUE	2	1	-1	5	96071	TRUE	12	96071	TRUE	2	96071
1553	JKISeason2-4	FALSE	16	17	18	2	7	5	-2	TRUE	24	7565	TRUE	2	0	-2	6	7565	TRUE	17	7565	TRUE	2	7565
1396	Group_13	FALSE	16	25	27	11	2	1	-1	TRUE	4	39650	TRUE	1	2	1	2	39650	TRUE	8	39650	TRUE	4	39650
2636	Power Calculation 1	FALSE	16	21	21	5	2	1	-1	TRUE	8	3740	TRUE	2	1	-1	4	3740	TRUE	4	3740	TRUE	2	3740
2816	Urbanization	FALSE	16	16	18	2	5	5	0	TRUE	17	50451	TRUE	2	1	-1	4	129847	TRUE	20	50451	TRUE	2	50451
1556	JKISeason2-4_rev00	FALSE	16	17	19	3	10	12	2	TRUE	34	24118	TRUE	3	2	-1	5	26739	TRUE	49	24118	TRUE	5	35258
242	20230424 Pikairos Simple Regression	FALSE	15	18	22	7	14	10	-4	TRUE	33	7823	TRUE	4	1	-3	7	7823	TRUE	33	7823	TRUE	2	7823
597	Case3C-Detecting Spatiotemporal Crime Hotspots in Baton Rouge	FALSE	15	22	23	8	14	5	-9	TRUE	28	32031	TRUE	2	2	0	6	32031	TRUE	10	32031	TRUE	2	32031
648	Challenge 15 - Extracting a Table from a PDF	FALSE	15	17	17	2	1	0	-1	TRUE	2	16651	TRUE	1	1	0	2	16651	TRUE	2	16651	TRUE	2	16651
1250	FASE I UNJBG C2	FALSE	15	23	26	11	9	28	19	TRUE	10	133205	TRUE	3	3	0	4	133205	TRUE	62	133205	TRUE	6	218405
593	Case2A1-Geocoding Hospitals and Estimating Euclidean and Manhattan Distances	FALSE	15	18	19	4	2	1	-1	TRUE	7	997404	TRUE	1	1	0	4	997404	TRUE	7	997404	TRUE	2	997404
2731	text processing	FALSE	15	26	26	11	1	2	1	TRUE	4	11923	TRUE	2	1	-1	3	11923	TRUE	4	11923	TRUE	2	11923
611	Case14A-Spatiotemporal Big Data Analytic-Rebuilding Taxi Trajectory	FALSE	15	21	24	9	1	2	1	TRUE	4	9.54E+07	TRUE	1	2	1	2	9.54E+07	TRUE	8	9.54E+07	TRUE	4	9.54E+07
2092	mantel para vivi  1	FALSE	14	24	21	7	1	1	0	TRUE	2	411062	TRUE	1	1	0	2	411062	TRUE	2	411062	TRUE	2	411062
2297	PLAN D	FALSE	14	21	24	10	4	7	3	TRUE	8	133429	TRUE	2	3	1	3	133429	TRUE	32	133429	TRUE	6	186818
556	C25_Detecting the Presence of Heart Disease	FALSE	14	28	33	19	2	1	-1	TRUE	4	20953	TRUE	2	1	-1	3	20953	TRUE	4	20953	TRUE	2	20953
528	BLOB_PARSE	FALSE	14	16	17	3	1	1	0	TRUE	3	1726249	TRUE	1	0	-1	2	1726249	TRUE	4	1726249	TRUE	3	1726249
705	Challenge_20_Patient_Network_Days	FALSE	14	22	24	10	7	14	7	TRUE	12	12364	TRUE	5	3	-2	5	12364	TRUE	28	12364	TRUE	5	26756
2296	PLAN C	FALSE	14	22	25	11	4	10	6	TRUE	6	133052	TRUE	3	2	-1	3	133052	TRUE	32	133052	TRUE	6	184641
2611	Spectral data extraction	FALSE	14	17	17	3	1	0	-1	TRUE	2	2858	TRUE	1	1	0	2	2858	TRUE	2	2858	TRUE	2	2858
2422	Reference Column Resorter fails for undefined Column Types	FALSE	14	13	16	2	50	114	64	TRUE	141	2.21E+07	TRUE	3	3	0	7	4.43E+07	TRUE	391	2.21E+07	TRUE	7	4.43E+07
656	Challenge 20 - Patient Network Days	FALSE	14	19	19	5	1	0	-1	TRUE	2	6679	TRUE	1	1	0	2	6679	TRUE	2	6679	TRUE	2	6679
2905	WTK_Polygon_to_geometry	FALSE	14	15	15	1	2	1	-1	TRUE	8	5271	TRUE	1	1	0	4	5271	TRUE	6	5271	TRUE	2	5271
2295	PLAN B	FALSE	14	22	25	11	5	7	2	TRUE	8	139047	TRUE	2	3	1	3	139047	TRUE	32	139047	TRUE	5	139047
2639	SteelFaultData	FALSE	14	32	38	24	4	2	-2	TRUE	3	127473	TRUE	2	2	0	2	127473	TRUE	4	127473	TRUE	3	127473
82	03. SVM_Son (SVR)	FALSE	13	16	20	7	5	7	2	TRUE	12	102908	TRUE	2	2	0	5	102908	TRUE	27	102908	TRUE	3	102908
612	Case14B-Spatiotemporal Big Data Analytic-Aggregating Taxi Trajectory between Grids	FALSE	13	25	30	17	74	99	25	TRUE	96	3797403	TRUE	6	5	-1	7	3797403	TRUE	181	3797403	TRUE	6	8999214
94	04. ANN-MLP_Son	FALSE	13	16	20	7	7	7	0	TRUE	11	103070	TRUE	3	2	-1	5	103070	TRUE	25	103070	TRUE	3	103070
2181	MT_SV_Analysis1_customer_churn	FALSE	13	28	29	16	4	5	1	TRUE	12	22843	TRUE	3	1	-2	3	67867	TRUE	11	22843	TRUE	2	22843
636	Challenge 04	FALSE	13	14	14	1	1	1	0	TRUE	2	14282	TRUE	1	1	0	2	14282	TRUE	2	14282	TRUE	2	14282
74	03. ANN Modeli (MLP)-R20,99	FALSE	13	16	20	7	14	10	-4	TRUE	12	359716	TRUE	4	2	-2	5	359716	TRUE	26	359716	TRUE	4	375364
57	02.GBT_Son	FALSE	13	16	20	7	6	9	3	TRUE	14	102666	TRUE	2	2	0	5	102666	TRUE	28	102666	TRUE	3	102666
116	05. DNN_Son	FALSE	13	22	26	13	22	32	10	TRUE	23	102470	TRUE	9	3	-6	6	102470	TRUE	52	102470	TRUE	3	102470
2025	LDG_Predictive	FALSE	13	19	20	7	1	1	0	TRUE	2	3491288	TRUE	1	1	0	2	3491288	TRUE	2	3491288	TRUE	2	3491288
2747	titanic-rf4	FALSE	13	18	19	6	2	2	0	TRUE	5	37314	TRUE	2	1	-1	3	37314	TRUE	7	37314	TRUE	3	37314
513	BDDAProject New	FALSE	13	32	35	22	11	10	-1	TRUE	9	34737	TRUE	4	4	0	4	34737	TRUE	31	34737	TRUE	6	68632
1037	Decision Tree Boundaries	FALSE	13	20	22	9	5	8	3	TRUE	17	817189	TRUE	2	2	0	5	817189	TRUE	26	817189	TRUE	3	817189
27	01.RF_Son	FALSE	13	17	21	8	5	14	9	TRUE	11	102384	TRUE	3	3	0	5	102384	TRUE	27	102384	TRUE	4	118032
1010	Date conversion-ADR	FALSE	13	19	18	5	1	0	-1	TRUE	2	6769	TRUE	1	0	-1	2	6769	TRUE	2	6769	TRUE	2	6769
1751	Justknimeit -S2C4	FALSE	12	14	14	2	1	0	-1	TRUE	2	14995	TRUE	1	1	0	2	14995	TRUE	2	14995	TRUE	2	14995
498	bank churn	FALSE	12	41	43	31	10	13	3	TRUE	11	54168	TRUE	4	3	-1	4	54168	TRUE	31	54168	TRUE	4	54168
1183	EXC_KNIME	FALSE	12	12	14	2	20	11	-9	TRUE	90	6834	TRUE	2	1	-1	7	6834	TRUE	50	6834	TRUE	2	26947
64	02_Outlier_Detection	FALSE	12	19	21	9	12	13	1	TRUE	28	177461	TRUE	5	2	-3	6	177461	TRUE	47	177461	TRUE	5	554313
1329	Forum Question - Month over Month Comparison	FALSE	12	15	16	4	2	3	1	TRUE	9	5419	TRUE	1	1	0	4	5419	TRUE	14	5419	TRUE	5	9032
1778	KNIME01	FALSE	12	12	14	2	17	15	-2	TRUE	89	7120	TRUE	2	1	-1	5	14290	TRUE	55	7120	TRUE	2	43937
603	Case6C-Function Fittings for Monocentric Models at the Township Level	FALSE	12	24	25	13	4	2	-2	TRUE	6	112672	TRUE	2	1	-1	4	112672	TRUE	6	112672	TRUE	2	112672
1424	Homework_Input-Output	FALSE	12	28	25	13	1	0	-1	TRUE	2	2689	TRUE	1	1	0	2	2689	TRUE	2	2689	TRUE	2	2689
2690	tareaknime	FALSE	12	12	14	2	25	14	-11	TRUE	91	7115	TRUE	3	1	-2	5	14279	TRUE	55	7115	TRUE	2	33477
1670	Just Knime It Challenge 2	FALSE	12	20	24	12	9	7	-2	TRUE	20	18593	TRUE	3	1	-2	6	18593	TRUE	17	18593	TRUE	2	18593
984	Data Wrangling _ Recursive Equation	FALSE	12	18	22	10	165	100	-65	TRUE	329	25831	TRUE	4	2	-2	7	68682	TRUE	207	25831	TRUE	2	25831
2772	01_Transform_Using_Group_By_and_Joiner_nodes	FALSE	11	15	17	6	3	1	-2	TRUE	7	14080	TRUE	1	1	0	4	14080	TRUE	7	14080	TRUE	2	14080
1245	2019_08_14_ExtractingMinimum&IndexFromColumns	FALSE	11	14	16	5	1	1	0	TRUE	4	7564	TRUE	1	0	-1	3	7564	TRUE	3	7564	TRUE	2	7564
1016	DateClustering 2023-01-10	FALSE	11	14	18	7	3	4	1	TRUE	5	32546	TRUE	1	1	0	2	32546	TRUE	16	32546	TRUE	5	32546
2505	Run Maestro, command	FALSE	11	13	12	1	1	0	-1	TRUE	2	103626	TRUE	1	1	0	2	103626	TRUE	2	103626	TRUE	2	103626
2173	MRA Project Final	FALSE	11	15	16	5	2	2	0	TRUE	5	44422	TRUE	2	1	-1	3	44422	TRUE	7	44422	TRUE	3	44422
2523	SAP GL Accounting Data Table Extract (BKPF and BSEG)	FALSE	11	13	13	2	1	1	0	TRUE	2	48966	TRUE	1	1	0	2	48966	TRUE	2	48966	TRUE	2	48966
977	Data Wrangling _ Handling Pipes with regexMatcher	FALSE	11	14	14	3	1	1	0	TRUE	4	8563	TRUE	1	1	0	3	8563	TRUE	3	8563	TRUE	2	8563
1625	Just Knime it-20	FALSE	11	18	18	7	1	1	0	TRUE	2	23370	TRUE	1	0	-1	2	23370	TRUE	2	23370	TRUE	2	23370
1393	2021_03_29_Grouped_Excel_Data_Processing	FALSE	11	14	14	3	1	0	-1	TRUE	2	9082	TRUE	1	1	0	2	9082	TRUE	2	9082	TRUE	2	9082
1860	KNIME_Credit_Card_Rating	FALSE	11	25	26	15	1	1	0	TRUE	3	30692	TRUE	2	1	-1	3	30692	TRUE	3	30692	TRUE	2	30692
1421	Maestro commands - highlight residues	FALSE	11	16	16	5	2	1	-1	TRUE	3	81311	TRUE	2	1	-1	3	81311	TRUE	4	81311	TRUE	2	81311
652	Challenge 18 - Categorizing Notes	FALSE	11	19	20	9	2	1	-1	TRUE	2	31590	TRUE	2	1	-1	2	31590	TRUE	2	31590	TRUE	2	31590
697	challenge5 contract dates	FALSE	11	13	13	2	2	1	-1	TRUE	3	7292	TRUE	2	0	-2	3	7292	TRUE	4	7292	TRUE	2	7292
2692	Tarea_Big_Data	FALSE	11	11	13	2	7	7	0	TRUE	40	13814	TRUE	2	1	-1	5	13814	TRUE	48	13814	TRUE	3	228310
2166	Movies	FALSE	11	19	20	9	1	0	-1	TRUE	2	6962	TRUE	1	0	-1	2	6962	TRUE	2	6962	TRUE	2	6962
1165	kn_forum_38571_pivot	FALSE	10	25	25	15	4	5	1	TRUE	4	9220	TRUE	2	3	1	3	9220	TRUE	8	9220	TRUE	4	10609
1689	Just KNIME It _ Challenge 015	FALSE	10	11	11	1	0	0	0	TRUE	2	137310	TRUE	1	1	0	2	137310	TRUE	2	137310	TRUE	2	137310
1691	Just KNIME It _ Challenge 020	FALSE	10	24	26	16	14	10	-4	TRUE	20	18502	TRUE	8	2	-6	5	18502	TRUE	25	18502	TRUE	3	19732
2887	Women in Government	FALSE	10	16	19	9	2	2	0	TRUE	4	16056	TRUE	1	1	0	3	16056	TRUE	7	16056	TRUE	3	16056
1657	Just KNIME it 20	FALSE	10	19	21	11	3	2	-1	TRUE	7	5392	TRUE	2	2	0	4	5392	TRUE	5	5392	TRUE	2	5392
2972	I218_LinearCorrelation	FALSE	10	16	16	6	3	1	-2	TRUE	8	4279	TRUE	1	1	0	4	4279	TRUE	4	4279	TRUE	2	4279
1179	excel unpivot	FALSE	10	15	16	6	2	2	0	TRUE	7	12293	TRUE	1	1	0	4	12293	TRUE	7	12293	TRUE	2	12293
2738	kn_example_traveling_salesman_problem_python	FALSE	10	15	15	5	1	0	-1	TRUE	2	10958	TRUE	1	1	0	2	10958	TRUE	2	10958	TRUE	2	10958
782	Column Splitter ycbing77 Rev 1	FALSE	10	16	16	6	1	0	-1	TRUE	2	3841	TRUE	1	1	0	2	3841	TRUE	2	3841	TRUE	2	3841
1559	JKISeason2-5 ver 1.2	FALSE	10	10	11	1	1	1	0	TRUE	4	266740	TRUE	1	1	0	3	266740	TRUE	8	266740	TRUE	4	400110
1517	JKI2_024_Fraudulent_Email_Address_Detection	FALSE	10	13	16	6	8	14	6	TRUE	12	36868	TRUE	2	2	0	4	36868	TRUE	52	24809	TRUE	7	61652
1043	kn_example_base64	FALSE	10	15	17	7	3	2	-1	TRUE	4	75468	TRUE	2	1	-1	2	75468	TRUE	8	75468	TRUE	4	75468
1509	jKi-9	FALSE	10	10	13	3	2	2	0	TRUE	6	3929448	TRUE	1	1	0	3	3929448	TRUE	8	3929448	TRUE	4	3931435
2165	Move groupings into blocks	FALSE	10	18	18	8	1	1	0	TRUE	2	9633	TRUE	1	1	0	2	9633	TRUE	2	9633	TRUE	2	9633
516	BD_tarea_Alvarado_Paz	FALSE	10	16	17	7	6	5	-1	TRUE	28	9673	TRUE	1	1	0	4	17860	TRUE	12	9673	TRUE	2	9673
633	Challenge-5 justknimeit 5	FALSE	10	16	17	7	2	2	0	TRUE	2	5265	TRUE	1	1	0	2	5265	TRUE	2	5265	TRUE	2	5265
2911	xml replacer with xml demo files	FALSE	10	16	16	6	2	1	-1	TRUE	5	3397	TRUE	1	1	0	4	3397	TRUE	5	3397	TRUE	2	3397
722	Cheminformatics	FALSE	10	12	12	2	1	1	0	TRUE	4	11411	TRUE	1	1	0	3	11411	TRUE	4	11411	TRUE	2	11411
704	Challenge_2_v1	FALSE	10	22	23	13	2	1	-1	TRUE	3	45420	TRUE	2	1	-1	2	45420	TRUE	4	45420	TRUE	3	45420
1854	KNIME_challenge_5_b	FALSE	10	16	16	6	1	1	0	TRUE	2	5281	TRUE	1	1	0	2	5281	TRUE	2	5281	TRUE	2	5281
1849	KNIME_challenge_20b	FALSE	10	15	16	6	1	1	0	TRUE	2	7050	TRUE	1	1	0	2	7050	TRUE	2	7050	TRUE	2	7050
980	Data Wrangling _ Most Frequent Wildcard Combinations	FALSE	10	22	23	13	1	1	0	TRUE	2	6334	TRUE	1	1	0	2	6334	TRUE	2	6334	TRUE	2	6334
596	Case3B-Area-Based Interpolations of Population in Baton Rouge	FALSE	10	20	22	12	10	17	7	TRUE	18	1610272	TRUE	4	4	0	5	1610272	TRUE	60	1610272	TRUE	6	2910056
515	BD_PRUEBA1	FALSE	10	16	17	7	8	5	-3	TRUE	28	9673	TRUE	3	1	-2	4	17858	TRUE	12	9673	TRUE	2	9673
1739	Justknimeit-S2C8	FALSE	10	29	32	22	3	2	-1	TRUE	6	88033	TRUE	2	2	0	3	88033	TRUE	7	88033	TRUE	3	88033
1174	02_ETL_Basics	FALSE	10	13	14	4	2	1	-1	TRUE	7	14078	TRUE	1	1	0	4	14078	TRUE	5	14078	TRUE	2	14078
420	Ajusting Quantities to be ordered to suppliers Minimum ordering quantities	FALSE	10	23	27	17	13	9	-4	TRUE	20	9799	TRUE	3	1	-2	6	9799	TRUE	21	9799	TRUE	2	9799
154	08_Topic Labeling via a Large Language Model (LLM) via Prompt Engineering (Experimental)	FALSE	10	24	27	17	2	2	0	TRUE	2	58315	TRUE	2	1	-1	2	58315	TRUE	2	58315	TRUE	2	58315
1582	JKI_014_Removing_Noise_from_Data	FALSE	10	11	13	3	1	1	0	TRUE	4	8736	TRUE	2	1	-1	2	8736	TRUE	8	8736	TRUE	4	8736
1452	kn_example_r_import_csv_r_readr	FALSE	9	12	13	4	2	2	0	TRUE	7	11057	TRUE	1	1	0	4	11057	TRUE	7	11057	TRUE	2	11057
1944	KNIME_project_Unsupervised 1	FALSE	9	21	21	12	5	4	-1	TRUE	6	5588402	TRUE	2	1	-1	4	5588402	TRUE	15	5588402	TRUE	3	5588402
2156	Modulo 2 - Episodio 5	FALSE	9	14	13	4	1	0	-1	TRUE	2	11166	TRUE	1	0	-1	2	11166	TRUE	2	11166	TRUE	2	11166
1835	KNIME_challenge12_solution	FALSE	9	17	18	9	1	1	0	TRUE	2	10997	TRUE	1	1	0	2	10997	TRUE	2	10997	TRUE	2	10997
1808	KnimeIT_15	FALSE	9	10	10	1	0	1	1	TRUE	2	57559	TRUE	1	0	-1	2	57559	TRUE	2	57559	TRUE	2	57559
2278	patients_treatments	FALSE	9	11	11	2	1	1	0	TRUE	2	7830	TRUE	1	1	0	2	7830	TRUE	2	7830	TRUE	2	7830
1586	JKI_020	FALSE	9	28	30	21	3	2	-1	TRUE	4	36845	TRUE	1	2	1	2	36845	TRUE	8	36845	TRUE	4	36845
2587	Solihin_Workflow1	FALSE	9	12	12	3	0	1	1	TRUE	2	17899	TRUE	1	1	0	2	17899	TRUE	2	17899	TRUE	2	17899
1699	justknimeit-15	FALSE	9	10	10	1	1	0	-1	TRUE	2	50637	TRUE	1	0	-1	2	50637	TRUE	2	50637	TRUE	2	50637
753	filterQuarter	FALSE	9	10	10	1	1	0	-1	TRUE	2	3053	TRUE	1	1	0	2	3053	TRUE	2	3053	TRUE	2	3053
2444	Remove Square Brackets from Column Cell	FALSE	9	11	11	2	1	1	0	TRUE	2	12957	TRUE	0	1	1	2	12957	TRUE	2	12957	TRUE	2	12957
364	ABC_Analysis_Naive_Approach	FALSE	9	14	14	5	2	1	-1	TRUE	2	2854	TRUE	1	0	-1	2	2854	TRUE	2	2854	TRUE	2	2854
2247	Order Expand	FALSE	9	13	13	4	1	1	0	TRUE	2	8175	TRUE	1	1	0	2	8175	TRUE	2	8175	TRUE	2	8175
408	kn_forum_27700_spot_rate_previous_month	FALSE	9	12	12	3	2	0	-2	TRUE	2	12801	TRUE	1	0	-1	2	12801	TRUE	2	12801	TRUE	2	12801
2722	TestElecConsump	FALSE	9	12	12	3	1	0	-1	TRUE	2	8740	TRUE	2	0	-2	2	8740	TRUE	2	8740	TRUE	2	8740
2183	MT_SV_Analysis3_Influence strategy KPI and customer_churn	FALSE	9	71	77	68	27434	102427	74993	TRUE	8217	30025	TRUE	51	36	-15	15	30025	FALSE	50001	30025	TRUE	14	128696
2741	Ticket Assignment 1	FALSE	9	18	19	10	2	1	-1	TRUE	4	3173	TRUE	2	1	-1	3	3173	TRUE	3	3173	TRUE	2	3173
1321	kn_example_r_import_csv_r_readr_force_all_string	FALSE	9	12	13	4	2	1	-1	TRUE	5	11057	TRUE	2	1	-1	4	11057	TRUE	7	11057	TRUE	2	11057
294	2019_07_29_24-Month_Period_Detection	FALSE	9	14	15	6	2	1	-1	TRUE	3	8927	TRUE	1	1	0	2	8927	TRUE	4	8927	TRUE	3	8927
2305	porosidade_eferro	FALSE	9	11	11	2	1	0	-1	TRUE	2	2327	TRUE	1	0	-1	2	2327	TRUE	2	2327	TRUE	2	2327
2681	Table Pivot without Aggregation	FALSE	8	15	18	10	10	30	20	TRUE	26	7877	TRUE	3	2	-1	6	7877	TRUE	116	7877	TRUE	5	11616
495	avocado's prices simple regression	FALSE	8	11	12	4	1	1	0	TRUE	4	135964	TRUE	1	0	-1	3	135964	TRUE	4	135964	TRUE	2	135964
1646	Challenge 15	FALSE	8	10	10	2	0	1	1	TRUE	2	128311	TRUE	1	1	0	2	128311	TRUE	2	128311	TRUE	2	128311
555	C24_Fraudulent Email Address Detection	FALSE	8	13	16	8	4	3	-1	TRUE	10	13303	TRUE	2	1	-1	5	13303	TRUE	11	13303	TRUE	2	13303
2518	SAP ECC Customer Returns Analysis	FALSE	8	20	21	13	2	1	-1	TRUE	3	22633	TRUE	1	1	0	3	22633	TRUE	3	22633	TRUE	2	22633
1638	Just Knime It-CH15	FALSE	8	10	10	2	1	0	-1	TRUE	2	52740	TRUE	2	1	-1	2	52740	TRUE	2	52740	TRUE	2	52740
2046	Linkedin Network Graph	FALSE	8	13	14	6	2	1	-1	TRUE	4	25795	TRUE	1	1	0	3	25795	TRUE	8	25795	TRUE	3	25795
647	Challenge 14_-_Removing Noise from Data	FALSE	8	10	11	3	1	1	0	TRUE	7	4797	TRUE	1	0	-1	4	4797	TRUE	5	4797	TRUE	2	4797
649	Challenge 15 Extracting a Table from a PDF	FALSE	8	10	10	2	1	0	-1	TRUE	2	57469	TRUE	1	0	-1	2	57469	TRUE	2	57469	TRUE	2	57469
1774	KN CH 04 _with loop	FALSE	8	10	11	3	1	0	-1	TRUE	2	10519	TRUE	1	0	-1	2	10519	TRUE	2	10519	TRUE	2	10519
853	Create a Rank variable with leading zeros - KNIME Forum (77507)	FALSE	8	10	11	3	4	1	-3	TRUE	4	319658	TRUE	2	1	-1	3	319658	TRUE	4	319658	TRUE	2	319658
598	Case4A-Defining Service Areas of Acute Hospitals in Baton Rouge	FALSE	8	20	25	17	184	1315	1131	TRUE	172	1097076	TRUE	7	10	3	5	2237201	TRUE	1917	1097076	TRUE	12	5229410
1162	example-for-case-switch	FALSE	8	11	13	5	1	1	0	TRUE	3	8344	TRUE	1	1	0	2	8344	TRUE	4	8344	TRUE	3	8344
1731	Justknimeit-S2C24	FALSE	8	17	20	12	17	39	22	TRUE	42	22106	TRUE	2	3	1	5	47893	TRUE	102	22106	TRUE	6	47893
979	Data Wrangling _ Mean  Swap by Categories	FALSE	8	19	23	15	3	4	1	TRUE	8	45400	TRUE	2	1	-1	4	45400	TRUE	13	45400	TRUE	3	45400
2416	red neuronal	FALSE	8	35	41	33	1	1	0	TRUE	2	22419	TRUE	2	1	-1	2	22419	TRUE	2	22419	TRUE	2	22419
358	99 - final workflow	FALSE	8	10	13	5	2	3	1	TRUE	5	50648	TRUE	2	1	-1	2	50648	TRUE	16	50648	TRUE	5	50648
1705	JustKnimeIt-20	FALSE	8	16	16	8	1	1	0	TRUE	2	5747	TRUE	1	1	0	2	5747	TRUE	2	5747	TRUE	2	5747
10	01-FIRST_project	FALSE	8	12	13	5	1	1	0	TRUE	3	1.43E+07	TRUE	1	1	0	3	1.43E+07	TRUE	4	1.43E+07	TRUE	2	1.43E+07
147	08 - apply formats	FALSE	8	10	13	5	2	5	3	TRUE	5	50648	TRUE	1	1	0	2	50648	TRUE	16	50648	TRUE	5	50648
1238	Extract SAP Purchasing Document Data, Invoice Data and Vendor Master Data from SAP ECC & SAP S_4HANA	FALSE	8	25	26	18	10	20	10	TRUE	15	221839	TRUE	2	3	1	3	316386	TRUE	59	221839	TRUE	7	471763
1335	2020_10_22_From_Excel_to_KNIME_Table_Unpivoting	FALSE	8	10	10	2	1	0	-1	TRUE	2	8061	TRUE	1	0	-1	2	8061	TRUE	2	8061	TRUE	2	8061
1571	JKISeasor2-29_tomljh_ver2	FALSE	8	11	13	5	2	2	0	TRUE	5	68484	TRUE	2	1	-1	3	68484	TRUE	16	68484	TRUE	4	68484
1455	kn_example_import_csv_r_readr	FALSE	8	11	12	4	1	0	-1	TRUE	3	13669	TRUE	1	1	0	3	13669	TRUE	3	13669	TRUE	2	13669
1511	JKI-S2-2	FALSE	8	11	12	4	3	3	0	TRUE	9	640281	TRUE	1	1	0	4	640281	TRUE	15	640281	TRUE	3	640281
2352	ProyectoReservaHotel	FALSE	8	11	11	3	1	1	0	TRUE	2	56815	TRUE	1	0	-1	2	56815	TRUE	2	56815	TRUE	2	56815
1259	fia project	FALSE	8	19	20	12	2	1	-1	TRUE	3	50931	TRUE	1	1	0	2	50931	TRUE	4	50931	TRUE	3	50931
2433	Regression on Text	FALSE	7	17	17	10	1	0	-1	TRUE	2	20249	TRUE	1	1	0	2	20249	TRUE	2	20249	TRUE	2	20249
2937	Кейс 34	FALSE	7	36	42	35	8	4	-4	TRUE	9	30227	TRUE	5	2	-3	5	30227	TRUE	10	30227	TRUE	2	30227
133	06 Dimensionality Reduction	FALSE	7	16	15	8	1	0	-1	TRUE	2	94534	TRUE	1	1	0	2	94534	TRUE	2	94534	TRUE	2	94534
1425	HousingMarketMadness	FALSE	7	20	21	14	1	2	1	TRUE	2	30309	TRUE	1	1	0	2	30309	TRUE	2	30309	TRUE	2	30309
395	Adv_Trees_Chap6_PMML	FALSE	7	11	12	5	3	1	-2	TRUE	4	14233	TRUE	2	1	-1	3	14233	TRUE	4	14233	TRUE	2	14233
910	CSV Duplicate Column Aggregation	FALSE	7	10	10	3	2	1	-1	TRUE	2	8531	TRUE	1	1	0	2	8531	TRUE	2	8531	TRUE	2	8531
2150	module 3 ch 01 lesson 1 finished project	FALSE	7	13	14	7	1	0	-1	TRUE	2	67679	TRUE	0	0	0	2	67679	TRUE	2	67679	TRUE	2	67679
605	Casee8B-Detecting Colocation between Crime Incidents and Facilities	FALSE	7	23	27	20	13	52	39	TRUE	12	5658515	TRUE	4	6	2	5	5658515	TRUE	121	5658515	TRUE	5	5658515
2148	Module 03 ch 01 lesson 01 Flow Variables final	FALSE	7	13	14	7	2	1	-1	TRUE	2	67679	TRUE	2	1	-1	2	67679	TRUE	2	67679	TRUE	2	67679
813	kn_forum_excel_2lines_header	FALSE	7	10	10	3	1	1	0	TRUE	2	11992	TRUE	1	0	-1	2	11992	TRUE	2	11992	TRUE	2	11992
1818	KnimeIT_25	FALSE	7	10	10	3	0	1	1	TRUE	2	53519	TRUE	1	0	-1	2	53519	TRUE	2	53519	TRUE	2	53519
1813	KnimeIT_20	FALSE	7	13	13	6	1	1	0	TRUE	2	14265	TRUE	1	1	0	2	14265	TRUE	2	14265	TRUE	2	14265
1550	JKISeason2-29_Revised tofusa's workflow	FALSE	7	10	11	4	1	1	0	TRUE	2	19096	TRUE	1	1	0	2	19096	TRUE	2	19096	TRUE	2	19096
266	20230903_FileReader	FALSE	7	12	10	3	2	1	-1	TRUE	8	6292	TRUE	1	1	0	4	6292	TRUE	6	6292	TRUE	2	6292
1729	JustKnimeit-S2C2	FALSE	7	17	18	11	3	2	-1	TRUE	12	25906	TRUE	3	1	-2	5	25906	TRUE	12	25906	TRUE	2	25906
1322	kn_example_r_import_csv_messy_loop_force_all_string	FALSE	7	10	10	3	1	1	0	TRUE	2	15989	TRUE	1	1	0	2	15989	TRUE	2	15989	TRUE	2	15989
645	Challenge 14 - Removing Noise from Data	FALSE	6	12	12	6	1	0	-1	TRUE	2	2621	TRUE	1	0	-1	2	2621	TRUE	2	2621	TRUE	2	2621
1538	JKISeason2-25@obito_od	FALSE	6	16	18	12	1	1	0	TRUE	2	33153	TRUE	2	0	-2	2	33153	TRUE	2	33153	TRUE	2	33153
2946	A110_ZeroPointTuning	FALSE	6	18	18	12	1	1	0	TRUE	4	6590	TRUE	1	0	-1	3	6590	TRUE	3	6590	TRUE	2	6590
1775	KNIME-It-08-06	FALSE	6	12	12	6	2	1	-1	TRUE	2	5743	TRUE	2	0	-2	2	5743	TRUE	2	5743	TRUE	2	5743
646	Challenge 14 Removing Noise from Data	FALSE	6	10	10	4	1	0	-1	TRUE	2	2896	TRUE	1	1	0	2	2896	TRUE	2	2896	TRUE	2	2896
1737	Justknimeit-S2C29	FALSE	6	10	11	5	1	2	1	TRUE	5	32256	TRUE	1	1	0	3	32256	TRUE	7	32256	TRUE	3	32256
247	20230531 Pikairos JustKNIMEIt Season 2 Challenge 10 Calculating YTD and MTD for Restaurant Yummy	FALSE	6	11	11	5	1	0	-1	TRUE	2	4959	TRUE	0	1	1	2	4959	TRUE	2	4959	TRUE	2	4959
909	CSV - Import Complex Structure - KNIME Forum (76935)	FALSE	6	15	16	10	2	1	-1	TRUE	3	4767	TRUE	2	0	-2	3	4767	TRUE	3	4767	TRUE	2	4767
1659	Just Knime It 20	FALSE	6	13	12	6	2	1	-1	TRUE	2	10837	TRUE	1	1	0	2	10837	TRUE	2	10837	TRUE	2	10837
1690	Just KNIME It _ Challenge 018	FALSE	6	12	12	6	1	1	0	TRUE	4	27107	TRUE	1	1	0	3	27107	TRUE	3	27107	TRUE	2	27107
1634	Just KNIME it-2_Challenge-29_v1	FALSE	6	14	16	10	1	1	0	TRUE	5	81540	TRUE	2	1	-1	3	81540	TRUE	8	81540	TRUE	4	122310
1539	JKISeason2-25_sryu	FALSE	6	15	17	11	1	1	0	TRUE	2	21614	TRUE	1	0	-1	2	21614	TRUE	2	21614	TRUE	2	21614
1216	02a. Histogram and Bar Chart - solution	FALSE	5	13	13	8	1	0	-1	TRUE	2	8576	TRUE	0	1	1	2	8576	TRUE	2	8576	TRUE	2	8576
2268	03_Parameter_Optimization_Loop_on_Logit_with_CV	FALSE	5	11	11	6	1	1	0	TRUE	2	94588	TRUE	2	1	-1	2	94588	TRUE	2	94588	TRUE	2	94588
1428	HR Analytics	FALSE	5	12	13	8	1	1	0	TRUE	2	297937	TRUE	1	0	-1	2	297937	TRUE	2	297937	TRUE	2	297937
557	C27_Exploring World Cup Datasets	FALSE	5	18	19	14	3	5	2	TRUE	7	20641	TRUE	2	2	0	4	20641	TRUE	15	20641	TRUE	5	41282
2133	kn_forum_57544_python_missing_values	FALSE	5	11	11	6	1	1	0	TRUE	2	45160	TRUE	1	1	0	2	45160	TRUE	2	45160	TRUE	2	45160
313	311162_311171_Project 1	FALSE	5	11	12	7	1	0	-1	TRUE	3	27398	TRUE	1	0	-1	2	27398	TRUE	4	27398	TRUE	3	27398
601	Case5B-Implementing the 2SVCA Method for Telehealth Accessibility	FALSE	5	13	13	8	1	1	0	TRUE	2	30380	TRUE	1	1	0	2	30380	TRUE	2	30380	TRUE	2	30380
600	Case5A-Measuring Accessibility of Primary Care Physicians in Baton Rouge	FALSE	5	23	26	21	37	52	15	TRUE	23	2684451	TRUE	6	5	-1	6	2684451	TRUE	116	2684451	TRUE	7	2769437
1187	Exercise 1	FALSE	5	19	17	12	2	1	-1	TRUE	3	7695	TRUE	1	1	0	3	7695	TRUE	4	7695	TRUE	2	7695
307	311006_311045_Project 2	FALSE	5	16	19	14	2	2	0	TRUE	6	14353	TRUE	1	1	0	4	14353	TRUE	7	14353	TRUE	2	14353
374	2020_09_25_Adding_Cluster_Labels_k-Means_Custering	FALSE	5	11	12	7	1	1	0	TRUE	3	9753	TRUE	0	1	1	3	9753	TRUE	3	9753	TRUE	2	9753
352	8.2 Practical Machine Learning with R Churn Analysis (balanced with SMOTE)	FALSE	5	13	14	9	2	1	-1	TRUE	3	172294	TRUE	1	0	-1	3	172294	TRUE	4	172294	TRUE	2	172294
1707	justKnimeit-20	FALSE	4	10	10	6	1	0	-1	TRUE	2	9607	TRUE	1	1	0	2	9607	TRUE	2	9607	TRUE	2	9607
1048	Delete Last Row	FALSE	4	11	11	7	2	1	-1	TRUE	2	3477	TRUE	1	1	0	2	3477	TRUE	2	3477	TRUE	2	3477
2007	LAB 3 Part 6	FALSE	4	12	12	8	1	1	0	TRUE	2	7864	TRUE	3	1	-2	2	7864	TRUE	2	7864	TRUE	2	7864
1308	Fit India Analysis	FALSE	4	12	12	8	1	2	1	TRUE	2	25583	TRUE	1	1	0	2	25583	TRUE	2	25583	TRUE	2	25583
131	06 Data Export and Reporting - Solution	FALSE	4	12	12	8	2	1	-1	TRUE	2	8643	TRUE	2	1	-1	2	8643	TRUE	2	8643	TRUE	2	8643
989	16_Database_Structure_Manipulation	FALSE	4	11	13	9	3	5	2	TRUE	6	14426	TRUE	3	2	-1	4	14426	TRUE	14	14426	TRUE	3	14426
945	Lab 3 - Data Export and Reporting	FALSE	4	12	12	8	1	1	0	TRUE	2	8795	TRUE	1	1	0	2	8795	TRUE	2	8795	TRUE	2	8795
2596	Solution 5 (Line Plot)	FALSE	4	10	10	6	1	0	-1	TRUE	2	20096	TRUE	0	1	1	2	20096	TRUE	2	20096	TRUE	2	20096
944	06 Data Export and Reporting	FALSE	4	12	12	8	1	1	0	TRUE	2	8795	TRUE	1	0	-1	2	8795	TRUE	2	8795	TRUE	2	8795
162	11 - Project 3 - Reporting	FALSE	3	10	10	7	0	0	0	TRUE	2	5050	TRUE	1	1	0	2	5050	TRUE	2	5050	TRUE	2	5050
1823	KnimeIT_9	FALSE	3	13	14	11	1	1	0	TRUE	2	208201	TRUE	1	0	-1	2	208201	TRUE	2	208201	TRUE	2	208201
1022	Day5_Ash	FALSE	3	10	10	7	2	0	-2	TRUE	2	15724	TRUE	1	1	0	2	15724	TRUE	2	15724	TRUE	2	15724
591	CASE-SWITCH-EXAMPLE	FALSE	3	12	13	10	2	0	-2	TRUE	4	5232	TRUE	2	1	-1	3	5232	TRUE	3	5232	TRUE	2	5232
1527	JKISeason2-10_sryu_ver2	FALSE	3	11	12	9	2	3	1	TRUE	11	10276	TRUE	2	1	-1	3	47533	TRUE	12	10276	TRUE	2	10276
1839	KNIME_challenge17_solution	FALSE	3	20	22	19	2	3	1	TRUE	5	175363	TRUE	2	2	0	3	175363	TRUE	8	175363	TRUE	3	175363
363	ABC_Analysis_Coefficient_of_Variability_Approach	FALSE	3	13	13	10	1	1	0	TRUE	2	29407	TRUE	1	0	-1	2	29407	TRUE	2	29407	TRUE	2	29407
586	Car Analysis Cross Validation Un Analista Peruano Init	FALSE	2	22	22	20	1	1	0	TRUE	2	12632	TRUE	2	1	-1	2	12632	TRUE	2	12632	TRUE	2	12632
1623	Just Knime it-035	FALSE	2	10	10	8	2	1	-1	TRUE	2	38591	TRUE	2	0	-2	2	38591	TRUE	2	38591	TRUE	2	38591
26	01. Remote Workflow Execution	FALSE	2	11	12	10	3	36	33	TRUE	7	596969	TRUE	2	1	-1	4	596969	TRUE	7	596969	TRUE	2	596969
1519	JKI2_027_Exploring_World_Cup_Datasets	FALSE	0	12	12	12	2	1	-1	TRUE	3	16395	TRUE	2	0	-2	3	16395	TRUE	4	16395	TRUE	2	16395